20 20
100 100
29 27 27 27 27 27 27 27 27 27 27 27 27 27 27 27 27 27 27 29
26 0 0 0 0 0 0 0 0 0 0 0 0 0 0 0 0 0 0 28
26 0 0 0 0 0 0 0 0 0 4 4 0 0 0 0 0 0 0 28
26 0 0 0 0 0 0 0 0 0 4 4 0 0 0 0 0 0 0 28
26 0 0 0 0 0 0 0 0 0 0 0 0 0 0 0 0 0 0 28
26 0 0 0 0 0 0 0 0 0 0 0 0 0 0 0 0 0 0 28
26 0 0 0 0 14 15 16 17 0 0 0 0 0 0 0 0 0 0 28
26 0 0 0 0 22 23 24 25 0 0 0 0 0 0 0 0 0 0 28
26 0 0 0 0 6 7 8 9 0 0 0 0 0 0 0 0 0 0 28
26 0 0 0 0 10 11 12 13 0 0 0 0 0 0 0 0 0 0 28
26 0 0 0 0 0 0 31 0 0 0 0 0 0 0 0 0 0 0 28
26 0 0 0 0 0 0 31 0 0 0 0 0 0 0 0 0 0 0 28
26 0 0 0 0 0 0 31 0 0 0 0 0 0 0 0 0 0 0 28
26 0 0 0 0 0 0 31 0 0 0 0 0 0 0 0 0 0 0 28
26 0 0 0 0 0 0 31 0 0 0 0 0 0 0 0 0 0 0 28
30 1 1 1 1 1 1 1 1 1 1 1 1 1 1 1 1 1 1 30
4 4 4 4 4 4 4 4 4 4 4 4 4 4 4 4 4 4 4 4
4 4 4 4 4 4 4 4 4 4 4 4 4 4 4 4 4 4 4 4
4 4 4 4 4 4 4 4 4 4 4 4 4 4 4 4 4 4 4 4
4 4 4 4 4 4 4 4 4 4 4 4 4 4 4 4 4 4 4 4